Signs:A,Coordinate:14 0,iconName:door
Signs:B,Coordinate:0 0,iconName:door
Signs:C,Coordinate:0 10,iconName:door
Signs:E,Coordinate:19 17,iconName:trophy

Karakter:Stormtrooper,Kapi:c
Karakter:darthVader,Kapi:B

1	0	0	0	1	0	1	1	1	0	0	0	1	1	1	0	0	0	1	0
1	1	0	1	1	0	0	1	0	0	1	1	0	0	0	0	0	1	0	1	
0	1	0	1	1	0	1	1	1	1	1	0	1	0	1	0	1	0	0	0	
0	1	1	1	1	0	0	1	0	1	1	1	0	0	0	0	0	0	0	0	
0	1	0	1	0	1	0	1	1	0	1	0	1	0	1	1	0	0	1	1	
1	1	0	1	0	0	1	0	0	1	0	1	0	0	1	0	0	1	0	0	
1	0	0	0	0	1	1	1	1	1	1	1	1	0	0	1	1	0	0	1	
0	0	1	1	0	1	1	1	0	1	0	0	1	0	0	1	1	1	0	1	
1	0	0	1	1	1	0	1	0	0	0	0	1	1	0	1	0	0	1	1	
1	1	1	0	1	1	0	1	1	1	0	1	0	1	1	0	1	1	1	1	
0	0	1	1	1	0	0	1	0	0	1	1	1	1	1	0	1	0	1	0	
1	0	1	0	1	1	0	1	1	1	1	1	1	0	0	1	1	0	1	1	
1	1	0	0	1	0	0	1	0	1	1	0	1	1	0	0	0	1	1	1	
1	1	0	1	1	1	1	0	1	1	1	1	0	1	1	1	0	0	0	1	
1	0	0	0	1	1	1	0	1	1	0	0	0	0	0	1	1	0	1	1	
1	1	0	0	1	0	1	1	0	0	0	0	1	0	1	1	0	1	0	1	
0	0	1	0	0	1	1	0	0	0	1	0	0	0	1	1	1	0	1	1	
1	1	0	0	0	1	1	1	1	1	1	1	1	0	1	0	1	1	1	1	
1	0	1	0	1	0	0	1	1	0	0	1	1	0	1	1	0	0	1	0	
1	0	1	1	1	1	1	1	1	1	1	1	1	0	0	0	0	1	1	0	
